37 0 0 0 0 31 31 0 0 0 31 31 0 0 0 0 0 37
37 0 0 0 31 31 31 0 0 0 31 31 31 0 0 0 0 37
37 0 0 31 31 32 31 31 31 31 31 32 31 31 0 0 0 37
37 0 0 31 32 32 31 31 31 31 31 32 32 31 0 0 0 37
37 0 0 31 31 32 31 32 32 32 31 32 31 31 0 0 0 37
37 0 0 0 31 31 31 32 32 32 31 31 31 0 0 0 0 37
37 0 0 31 31 32 31 32 32 32 31 32 31 31 0 0 0 37
37 0 0 31 32 32 31 31 31 31 31 32 32 31 0 0 0 37
37 0 0 31 31 32 31 31 31 31 31 32 31 31 0 0 0 37
37 0 0 0 31 31 31 0 0 0 31 31 31 0 0 0 0 37
37 0 0 0 0 31 31 0 0 0 31 31 0 0 0 0 0 37
