3 3 3 3 3 3 3 3 3 3 3 3 3 3 3 3 3 3
3 0 1 0 2 0 1 0 1 2 0 1 0 2 0 1 0 3 
3 0 2 0 1 0 2 0 2 1 0 2 0 1 0 2 0 3
3 4 1 4 2 4 1 4 1 2 4 1 4 2 4 1 4 3
3 0 2 0 1 0 2 0 2 1 0 2 0 1 0 2 0 3 
3 0 1 0 2 0 1 0 1 2 0 1 0 2 0 1 0 3 
3 3 3 3 3 3 3 3 3 3 3 3 3 3 3 3 3 3
