27 27 27 27 0 0 0 0 0 0 0 0 0 0 27 27 27 27
27 26 26 27 0 0 0 0 0 0 0 0 0 0 27 26 26 27
27 27 27 27 0 0 0 0 0 0 0 0 0 0 27 27 27 27
0 0 0 0 0 0 27 27 27 27 27 27 0 0 0 0 0 0 
0 0 0 0 0 0 27 26 26 26 26 27 0 0 0 0 0 0
0 0 0 0 0 0 27 26 26 26 26 27 0 0 0 0 0 0
0 0 0 0 0 0 27 27 27 27 27 27 0 0 0 0 0 0
27 27 27 27 0 0 0 0 0 0 0 0 0 0 27 27 27 27
27 26 26 27 0 0 0 0 0 0 0 0 0 0 27 26 26 27
27 27 27 27 0 0 0 0 0 0 0 0 0 0 27 27 27 27

